7111111111111111111111111111111771111111111111111111111111111117
6711111111111111111111111111117667111111111111111111111111111176
6672222222222222222222222222276666722222222222222222222222222766
663..........................566663.........................M566
663..........................566663..........................566
663..........................566663..........................566
663..........................-====0..........................566
663..........................GGBBGG..........................566
663............P.............GGBBGG.........................M566
663..........................GGBBGG..........................566
663..........................GGBBGG..........................566
663..........................-====0..........................566
663..........................566663..........................566
663..........................566663..........................566
663..........................566663.........................M566
6674444444444444444444444444476666744444444449GGGG94444444444766
671111111111111111111111111111766711111111111QGGGGQ1111111111176
711111111111111111111111111111177111111111111QDDDDQ1111111111117
711111111111111111111111111111177111111111111QDDDDQ1111111111117
671111111111111111111111111111766711111111111QGGGGQ1111111111176
6672222222222222222222222222276666722222222228GGGG82222222222766
663...........S..............566663.........................S566
663....M.....................566663..........................566
663..........................566663..........................566
663..........................-====0...77................77...566
663.......777777777777.......GGBBGG...7..................7...566
663.......777777777777.......GGBBGG...7..................7...566
663.......777777777777.......GGBBGG...7.................S7...566
663.......777777777777.......GGBBGG...7S.................7...566
663..........................-====0...77......7777......77...566
663....M...........M.........566663..........................566
663..........................566663..........................566
663....S.....................566663..........................566
66744444444449GGGG9444444444476666744444444444444444444444444766
6711111111111QGGGGQ111111111117667111111111111111111111111111176
7111111111111QDDDDQ111111111111771111111111111111111111111111117
7111111111111QDDDDQ111111111111771111111111111111111111111111117
6711111111111QGGGGQ111111111117667111111111111111111111111111176
66722222222228GGGG8222222222276666722222222222222222222222222766
663.S..7.....................566663...........M.............M566
663....7.....................566663..........................566
663..........................566663....................M7....566
663.....7..............7.....-====0.........77.........77....566
663..........................GGBBGG.........7M...............566
663..........................GGBBGG.........................M566
663..........................GGBBGG..........................566
663..........................GGBBGG............M7............566
663777777..............7.....-====0............77.....77.....566
663..........................566663..........................566
663..S.......................566663..........................566
663M...........M............M566663.........................M566
6674444444444444444444444444476666744444444449GGGG94444444444766
671111111111111111111111111111766711111111111QGGGGQ1111111111176
711111111111111111111111111111177111111111111QDDDDQ1111111111117
711111111111111111111111111111177111111111111QDDDDQ1111111111117
671111111111111111111111111111766711111111111QGGGGQ1111111111176
6672222222222222222222222222276666722222222228GGGG82222222222766
663..........................5666637777..S...............7777566
663.....M............S.......566663777....................777566
663..........................56666377.................S....77566
663...7..7..7..7..7..7..7....-====07........................7566
663......7.....7........7....GGBBGG..........................566
663........M.......S.........GGBBGG.........................M566
663..........................GGBBGG..........................566
663...7........7.....7.......GGBBGG..........................566
663...7..7..7..7..7..7..7....-====07....................S...7566
663..........................56666377......S...77..........77566
663....M........S............566663777........7777........777566
663..........................5666637777......777777......7777566
66744444444449GGGG9444444444476666744444444444444444444444444766
6711111111111QGGGGQ111111111117667111111111111111111111111111176
7111111111111QDDDDQ111111111111771111111111111111111111111111117
7111111111111QDDDDQ111111111111771111111111111111111111111111117
6711111111111QGGGGQ111111111117667111111111111111111111111111176
66722222222228GGGG8222222222276666777777777777777777777777777766
663..........................566667..........................766
663......M..............M....566667..........................766
663..........................566667..........................766
663...77................7....-====0..........................766
663....7....7......7.........GGBBGG.............F............766
663......M..7......7..M......GGBBGG..........................766
663.........7......7.........GGBBGG..........................766
663.........7......7....7....GGBBGG..........................766
663...7.................77...-====0..........................766
663...M......................566667..........................766
663.............M........M...566667..........................766
663..........................566667..........................766
6674444444444444444444444444476666777777777777777777777777777766
6711111111111111111111111111117667111111111111111111111111111176
7111111111111111111111111111111771111111111111111111111111111117
